beyond - mögé
without - nélkül
from - tizenöttől, elől, hattól
off - kifelé, biciklidről, elfelé
on - bekapcsolva, án, rajta
within - belül
as - amint, valamiként, miközben
along - végig- (megy/sétál), magával/magukkal (visz/nek), mentén
against - ellene
per - -nként (pl. óránként, fejenként), -nta/-nte (pl. naponta, évente)
until then - Addig
about to - készülsz
before - előtt
beneath - alatt, alattatok
by now - mostanra
into - bele
at - iskolánknál, show-nál, diplomaosztónál
unlike - ellentétben, eltérően
among - közé, között, körében
with - táskával, dobozzal, sérülésem
across - át
like this - ilyen, így
of me - énrólam, belőlem, rólam
in here - itt
near - közelébe, környékén, közel
until - koromig, amíg … nem, négyig
by then - addigra
stepfather - mostohaapa
through - keresztül, át
under - alul, alatt, alá
during - közben, alatt, folyamán
underneath - alatt
in - alatt, bent, be
for - részére, helyette, tartó
than - amennyire, mint
up to you - rajtad múlik
toward - felém, feléjük, felé
after - után, miután, ezután
across from - szemben
between - közé, között, közötti
by - szerint, el, mellett
from now - mostantól
of - közül
as if - mintha
