partly - részben
overnight - éjjel, éjszaka
meanwhile - eközben
as well - is
furthermore - továbbá
loudly - hangosan
right away - azonnal
beside - mellett, mellé
mainly - főleg
totally - teljesen
initially - eleinte
afterward - utána
actually - valójában
amazingly - hihetetlenül, elképesztően, meglepően
far away - messze
right here - pont itt
later - később
exactly - pontosan
yearly - éves
ago - ezelőtt
alike - hasonlít, hasonló, egyformán
professionally - profi módon
besides - amúgy, ezenkívül, mellett
fifth - ötödik
just now - az imént
together - együtt
nowadays - manapság
perfectly - tökéletesen, teljesen
internationally - nemzetközileg
all about - mindent
anyhow - Mindenesetre
down - le, lent
alternatively - alternatív megoldásként, vagy esetleg
roughly - durván
extremely - rendkívül
even though - noha, bár, annak ellenére, hogy
anywhere - semerre, sehol, sehova
a.m. - reggel
plain - egyszínű, sima
afterwards - utána
aloud - hangosan
quickly - gyorsan
obviously - nyilvánvalóan
briefly - röviden
also - is
more often - gyakrabban
probably - valószínűleg
nevertheless - mindazonáltal
up - fel, fent, fenn
often - gyakran
practically - gyakorlatilag
at all - egyáltalán, sehogy sem
early - korán
ever - valaha
alone - egyedül
accidentally - véletlenül
no longer - többé
politely - udvariasan
currently - jelenleg
truly - valóban, igazán
even - még
recently - mostanában, nemrég
smelly - büdös
p.m. - délután
nearby - közel, közelben
out there - ott kint
less - kevésbé
secretly - titokban
abroad - külföld, külföldön
anymore - már, tovább
easily - könnyen
daily - napi
only - csak
fairly - eléggé, viszonylag, meglehetősen
away - távol
next to - mellett, mellé
finally - végre
better - jobb
generally - általában
here's - itt van, tessék, íme
equally - egyformán
far - messze
clear - átlátszó
here is - íme, itt
twice - kétszer
carefully - óvatosan, gondosan
otherwise - máskülönben
admittedly - Be kell vallani
tattoo - tetoválás
completely - teljesen, maradéktalanul
long - hosszú
slowly - lassan
ahead - előtt, előre
overseas - külföldön, külföldre, külföldről
precisely - pontosan
already - már
always - mindig
usually - általában
normally - rendszerint
maybe - talán
almost - majdnem
absolutely - abszolút, Abszolút
supposedly - feltehetően
definitely - határozottan
clearly - tisztán
takeout - elvitelre
necessarily - szükségszerűen
more - még több
personally - személyesen, személy szerint
considerably - jelentősen
eventually - végül
especially - különösen
outdoors - kint
beautifully - szépen
well - jól
nowhere - sehova, sehol, semerre
hopefully - remélhetőleg
all right - rendben
immediately - azonnal
after all - végül is
northeast - északkelet
enough - elég
then - utána
consequently - ennek következtében
somehow - valahogy
way too - túlzottan
forever - örökre
occasionally - alkalmanként
first - először
very much - nagyon
safely - biztonságosan
yet - még, már
formerly - régen
oops - hoppá
potentially - potenciálisan
nearly - majdnem
jelly - dzsem
soon - hamarosan
instead - inkább
certainly - biztosan
silently - csendben
downstairs - a földszinten
however - azonban
mostly - többnyire
constantly - állandóan
once - egyszer
approximately - hozzávetőleg, megközelítőleg, nagyjából
fortunately - szerencsére
instantly - azonnal
worst - legrosszabb
specially - különlegesen, kifejezetten
first of all - először is
now - most
typically - jellemzően
appropriately - megfelelően, illemesebben
here are - itt van(nak)
as well as - valamint
lately - az utóbbi időben, utóbbi, mostanában
possibly - esetleg, talán
upstairs - az emeleten
around - körül
sometime - egyszer, valamikor
straight - egyenesen
regularly - rendszeresen
quite - elég, egészen, igen
incredibly - hihetetlenül
apparently - Úgy tűnik
again - újra
hardly - alig
just - csak
surely - Biztosan
nationwide - országosan, országos, országszerte
monthly - havi
shortly - rövidesen
basically - alapvetően
inside - belső, belseje, belül
else - mást, másról, még (másvalami)
behind - mögött, hátul, mögé
sore - fáj
here - itt
here is your - Itt van a te, Itt van az
forward - elő
prior - Mielőtt
gradually - fokozatosan
over there - ott
never - sosem
outside - kint
anyway - mindegy, úgysem
sincerely - őszintén
pretty - csinos
highly - nagyon
most - legtöbb
rather - elég, egészen, hanem
online - online
really - nagyon
still - még mindig
slightly - kissé
so - tehát, így, ezért
late - késésben
closer - közelebb, közelebbről
back - hát, hátul, hátsó
either - sem
surprisingly - meglepően
temporarily - ideiglenes
very - nagyon
above - föléd, fölé, fölött
worldwide - világhírűvé, világsiker
previously - korábban, előzőleg
badly - nagyon
nd - 2-án, 2., 42.
out - kimegyünk, kifelé, kint
about - amiatt, kapcsolatban, körül
too - is
kind - kedves
sooner - előbb, hamarabb
rarely - ritkán
seriously - komolyan
right now - éppen most
sometimes - néha
honestly - őszintén
frankly - őszintén
dangerously - veszélyesen
late for - Késésben, késésben
permanently - véglegesen
farther - távolabb, tovább
best - a legjobb
unfortunately - sajnos
wide - széles
suddenly - hirtelen
close - zár
so much - olyan sok
over - véget ér
quietly - halkan
so far - eddig
luckily - szerencsére
perhaps - talán
as soon as - mihelyt
