is from - származik
cannot - kérheted, nem (csinál)hat (vmit), nem
shouldn't - kéne, kellene
will - lesz, majd, fogja
wasn't - nem voltam, nem, nem volt
could - tudtalak, tudtál, -hat
been - lett, jártál, volt
was - volt, voltam
am - vagyok
will you - fogjátok, fogsz, fogod
shall we - jó
are there - van
should - kellene, kéne
would - volna
must not - Nem szabad
can't - nem, nem tud
being - lények, lenni/vagy, létre
may - május, talán, -hat, -het
won't - nem, nem fog
are - vannak
will be - lesz
is - az, van, áll
is there - Van-e
weren't - nem voltak, nem lenne
been to - voltak, voltál
isn't - nem, nincs
is this - ez, van
isn't it - ugye, nem
may be - lehet
will you be - leszel, lesztek
aren't - ugye, nem, nincsenek
wouldn't - lenne, lennék, lett volna
must - biztosan, lennetek, kell
couldn't - láttam, láttunk, találtuk
is it - van
might - lehet
can - lehet, vehetjük, tudnak
were - voltunk, voltál, voltatok
be - lenniük, legyél, légy
May - május
