literature - irodalom
stairs - lépcsői, lépcső, lépcsőn
inbox - postaláda
over time - idővel, az idők során, az idők folyamán
bra - melltartó
honey - méz
video - videó
oil - olaj
penny - fillér
confirmation - megerősítést
thanks for - Köszönöm, Köszönjük
paper - papír
a bit - egy kicsit
corn - kukorica
description - leírás
victory - győzelem
outskirts - külváros
northwest - északnyugat
invention - találmány
bravery - bátorság
use - használ
burger - hamburger
night - éjszaka
market - piac
quarter - negyed
user - felhasználó
good afternoon - jó napot
wash - mos
guidelines - irányelvek
difference - különbség
cancer - rák
architecture - építészet
seed - mag
feedback - visszajelzés
port - kikötő
coupon - kupon
scrub - dörzsöl, megdörzsöl
fur - szőrme
childhood - gyerekkor, gyerekkorom
policy - politika
ice - jég
killer - gyilkos
farm - farm
southwest - délnyugat
period - korszak, periódus, időszak
butterfly - pillangó, lepke
pile - halom
motive - indíték
background information - háttér-információ
uniform - egyenruha
sequel - folytatás
jeans - farmer
design - terv
eraser - radír
sheep - juhukat, juhok, juh
coin - érem
arrival - érkezés
actress - színésznő
animation - animáció
chase - üldözni, üldözi, üldöztük
flood - árvíz
mistake - hiba
trailer - előzetes
spare time - szabadidő
ticket - jegy
part-time - részidős
pollution - szennyezés
housework - házimunka
recovery - felépülésed, felépülése, felépülés
secretary - titkár
color - szín
alarm - ébresztő, riasztó
salmon - lazac
soul - soul
example - példa
coffee shop - kávézó
chemistry - kémia
next day - másnap
egg - tojás
email address - e-mail-cím
card game - kártyajáték
tiger - tigris
living room - nappali
date - dátum, dátumnak, időpont
official - hivatalos
intermission - szünet
fix - megjavít
pork - disznóhús
arrange - rendezed, elrendezése
rd - 3., 23., 3-a
mountain - hegy
physics - fizika
platform - peron, vágányt, peronról
family - család
helmet - sisak
prayer - ima
cart - bevásárlókocsi
dream - álom
climate - éghajlat
text message - szöveges üzenet
someplace - valahol, máshová, valahova
cupboard - szekrény, szekrényed, szekrényedben
by accident - véletlenül
dress - ruha
village - falu
scenery - táj
tutor - magántanár
customs - szokása, vám
synagogue - zsinagóga
household - háztartási
price - ár
deadline - határidő
aspirin - aszpirin
stadium - stadion
spicy - fűszeres
solution - megoldás
full-time - teljes idős
atmosphere - légkör, atmoszféra, hangulat
part - rész
babysitter - bébiszitter
first name - keresztnév
champion - bajnokok, bajnok
hometown - szülőváros
service - szolgáltatás, ügyfélszolgálat, kiszolgálás
chess - sakk
leaf - falevél, levél
dashboard - műszerfalra, műszerfala, műszerfalat
lifestyle - életmód
archeologist - régész
retirement - nyugdíjban
preference - preferencia, előnyben
jacket - kabát
forties - negyvenes éveinkben, negyvenes éveimben
temperature - hőmérséklet
out-of-date - elavult
vegan - vegán
purchase - megvásárol, vásárlás, vásárol
parents - szülők
investor - befektető
soundtrack - filmzene
cent - cent
tourist - turista
in a hurry - sietve
what time - mikor
tons of - rengeteg
slice - szelet
pottery - kerámiák
bedtime - lefekvés ideje
level - szint
costume - kosztümje, jelmezemet
grandchildren - unokák
computer - számítógép
on the ground - a földön
capital - főváros
touch - megérint
a lot of - sok
cycling - biciklizés, kerékpározást, kerékpározás
thesis - szakdolgozatomat, szakdolgozatom
frustration - frusztrációd, frusztráció
path - út
architect - építész
bicycle - bicikli
insult - sértésnek
impact - hatása
o'clock - órakor, óra
science - tudomány
from time to time - időről időre, időnként
insurance - biztosítás
windshield - szélvédő
weights - súlyemelés, súlyok, súlyzókat
rent - bérel
teeth - fog, fogak, fogaid
purple - lila
pleasure - élvezet, öröm
anxiety - szorongás
front desk - recepció
illness - betegség, betegségben
episode - epizód
film - film, filmet (acc.), filmhez
jazz - dzsessz
section - részleg
at home - otthon, itthon
air conditioning - légkondicionálás
reserve - lefoglalja, lefoglal, (le)foglal
silver - ezüst
all day - egész nap
doctor's office - orvosi rendelő
citizen - polgár, állampolgár
salon - szalon, fodrászat
legend - legenda
participation - részvétel
treadmill - futópad
ad - reklám
planet - bolygó
member - tag
bit - darabka, egy kicsi, egy kevés
deposit - befizet
release - kiadni
sunburn - Leégtél
pronunciation - kiejtés
spy - kém
tail - farok
gymnastics - torna
ring - gyűrű
label - címke, címkét, címkéje
footprint - lábnyomot
pocket - zseb
fruit - gyümölcs
harvest - aratás, betakarítás
regret - megbánni
printer - nyomtató
conversation - beszélgetés
silence - csend
ladies and gentlemen - hölgyeim és uraim
no one - senki
court - udvarol, udvar, bíróság
condition - állapot, feltétel
skip - kihagy
guard - őr
chair - szék
unemployment - munkanélküliség
mustard - mustár
history - történelem
calculator - számológép
neighborhood - környék
eye - szem
police report - rendőri jelentés
underline - aláhúz
planner - határidőnapló
hairstyle - frizura
news - hírek
side effect - mellékhatás
an f - egy F
proof - bizonyíték
entrance - bejárat
customer - ügyfél
bleed - vérzik
branch - ág, ágat (acc)
in the end - végül, Végül is
moment - pillanat
global warming - globális felmelegedés
scissors - olló
good evening - jó estét
majority - többség
driveway - kocsibeállón, kocsibeállót
leisure - szabadidő
toast - pirítós
appointment - időpont
campus - kampusz
journey - utazás, út, utazásunkra
ages - korok
bathroom - fürdőszoba
ceiling - mennyezet
whisper - suttogni
prison - börtön
comic book - képregény
niece - unokahúg, unokahúgom
female - nő(i)
lime - zöldcitrom, lime
pyramids - piramisok
bandage - sebtapasz
jar - befőttesüveg
sign - tábla
for example - például
in court - a bíróság előtt, a bíróságon
what time is it - hány óra van
success - siker, sikert
regards - üdvözlet
mood - hangulat
invitation - meghívó
wood - fa
message - üzenet
threat - fenyegetés
instrument - hangszer
instructions - utasítások
amount - összeged, összeg, mennyiség
salary - fizetés
matter - gond, anyag, téma
shave - borotválni
for a while - egy ideig
agriculture - mezőgazdaság
nurse - ápoló
cyclist - biciklista, kerékpáros, biciklis
distract - zavarj
profit - profittal
teacher - tanár
cat - macska
guy - srác
condolences - részvét
in theory - elméletileg, elvileg
choice - választás
animal - állat
approval - jóváhagyását, engedély
finish - befejez
north - észak
deceive - becsapni
job - munka
flag - zászló
evil - rossz, gonosznak, gonoszak
mixer - mixer
happy birthday - boldog születésnapot
goal - cél
holiday - ünnep
speed - sebesség, sebességét
summit - csúcson, csúcsig, csúcs
carrot - répa
reread - újra el kell olvasniuk, újraolvas
reason - ok
payment - fizetés
judge - bírót, bíró
things - dolgainkat, dolgaimat, dologra
grandma - nagymama, nagyi
gossip - pletykál
mystery - rejtély
plot - cselekmény
incident - eset, esemény
lane - sáv
obsession - megszállottja, megszállottság
high school - középiskola
study - tanul
map - térkép
french fries - hasábburgonya
trade - kereskedelmi, kereskedelem
championship - bajnokság, bajnokságot
picture of - képet egy
collar - (ing) nyaka
foreigner - külföldi
blog - blog
sink - mosogató
consequence - következmény
title - cím, címe, címmel
coffee table - kávézóasztal, dohányzóasztal
grocery store - élelmiszerbolt
superb - nagyszerű
theme - téma
candidate - jelölt
those ones - azok
a number of - számos
magic - varázslat, mágikus
pot - fazék
relaxation - relaxálás
system - rendszer
thumb - hüvelykujjam
offense - támadás
mushroom - gomba
antique - antik
area - terület
jewelry - ékszer
reservation - foglalás
roof - tető
evidence - bizonyíték
allergy - allergia
boat - hajó
course - tanfolyam
bird - madár
offend - megsért, sért
ball - labda
bucket - vödör
ceremony - ünnepség
tissue - zsebkendő
circumstance - körülmények
swimsuit - fürdőnadrágot, fürdőruha, fürdőruhát
package - csomag
death - halál, halált
habit - szokás
picture - kép
author - szerző
diamond - gyémánt
arrow - nyilat
cream cheese - krémsajt
generation - nemzedék, generáció, korosztály
donkey - szamár
time - idő
effort - erőfeszítés
classroom - osztályterem
spouse - házastárs
landscape - tájkép, táj, látkép
basket - kosár
brush - hajkefe
plate - tányér
action - felvétel, tett, akció
media - média, médiát
assistant - asszisztens
shelves - polcokat, polcok, polcokon
word - szó
shrimp - garnélarák
fitness - fitnesz
dragon - sárkány
task - feladat
count - (meg)számol, számolnak, számítanunk
tree - fa
pattern - minta
pain - fájdalom
alibi - alibi
tomorrow - holnap
snake - kígyó
maintenance - karbantartás
hat - sapka
flute - fuvola
water bottle - vizesüveg
goddess - Istennő
lecture - előadás
wedding - esküvő
goalkeeper - kapus, kapust
theory - teória, elmélet
designer - tervező, divattervező
biography - életrajz
water - víz
hip - csípő
artist - művész
flexibility - hajlékonyság
garbage - szemét
marriage - házasság, házasságkötés, házassági
love at first sight - szerelem első látásra
meat - hús
ankle - boka
minute - perc
invent - feltalálnia
furniture - bútor
springtime - tavasz
olive - olajbogyó
party - buli
health insurance - egészségbiztosítás
day off - szabadnap
boot - csizma
conference room - konferenciaterem
expert - szakértő
bottom - fenék
property - tulajdon, birtok, ingatlan
program - program
heart - szív
euro - euró
cupcake - cupcake
teenager - tinédzser
slide - csúszdán, csúszda, csúszdája
bruise - zúzódás
teaspoon - teáskanál
grass - fű
experience - tapasztalat
home - otthon, otthonukat, itthon
balloon - lufi
vaccine - védőoltást, védőoltás
sandwich - szendvics
sir - úr
paper towel - papírtörlő
embassy - nagykövetség
twenty-fifth - huszonötödik
recess - szünet
improvement - javulás
character - szereplő
snack - harapnivaló
decision - döntés
utensils - evőeszközök
prize - díj
end - véget ér
island - sziget
coach - edző
yay - hurrá
graphics - grafikája
technology - technológia, technika (műszaki)
postcard - képeslap
trouble - gond, baj
feed - megetet
coincidence - véletlenül, véletlen
gasp - felkiált, felkiáltani, felkiáltsak, felkiáltott
volleyball - röplabda
main course - főétel
after school - az iskola után
dolphin - delfin
connection - kapcsolat
operation - műtét
thanks - köszi
sleepover - ottalvós buli
consideration - figyelembe
stress - stressz
mute - lenémít
cafeteria - menza
hospital - kórház
sword - kard
treasure - kincsvadászatok
civilization - civilizáció
souvenir - szuvenír
request - kérni
relationship - kapcsolat
in the middle of nowhere - a semmi közepén
management - menedzsment
toy - játék
translation - fordítás
stove - tűzhely
wing - szárny
tour - túra
surf - szörföl
apple - alma
decade - évtized
speaker - hangszóró
tag - bújócskáznának, bújócskát, bújócskában
public - nagyközönség, nyilvánosság, nyilvános
on foot - gyalog
tonight - ma este
restroom - mosdó
position - állás
promotion - előléptetés
career - életpálya, karrier, pályafutás
berries - bogyókat, Bogyókat, bogyószedés
this one - ez
brother - fiútestvér
protest - tüntetés
block - háztömb
barbecue - grillezett étel
emergency - sürgősségi osztály, vészhelyzet
travels - utazik, halad
name - vezetéknevünk, keresztnevét, név
neck - nyak
contract - szerződés, szerződést
solar system - naprendszer
hairdresser - fodrász
luxury - luxus
stuff - dolog
brunch - villásreggeli
search - kutatás, keresés, keres
agreement - megegyezés, megállapodás, megállapodást
nose - orr
season - évszak
stage - színpad
these days - manapság
performance - előadás, előadásra, előadásuk
sleep - alszik
zebra - zebra
actor - színész
textbook - tankönyv
fireplace - kandalló
engineering - mérnöki
trip - utazás
earthquake - földrengés
messy - rendetlen
in the afternoon - délután
hers - övé, az övét
son - fia
women - a nők, nőket, nők
guitar - gitár
equality - egyenlőség
vintage - vintage, régi
spice - fűszer
with a card - kártyával
print - nyomtat
happiness - boldogság
the sky - az ég, az égen
semester - félév
orphan - árva
weakness - gyengeség
view - kilátás
tea - tea
currency - pénznem
pronounce - kiejteni
sense of humor - humorérzék
sport - sport
pasta - tészta
robbery - rablás
ghost - szellem
impression - benyomás
glue - ragasztó
region - terület, régió, térség
no problem - semmi gond
dining room - étkező
camera - fényképezőgép
arm - kar
good job - szép munka
background - háttér
mother - anya
point - pont
filmmaker - filmkészítő
dance - táncol
immigration - bevándorlás
doctor - orvos
situation - helyzet, helyzetet
dishwasher - mosogatógép
headphones - fejhallgató
faculty - kar
expectation - elvárás, elvárása
competition - verseny
birthday - születésnap
songwriter - dalszerző
lack - hiány
reunion - összejövetel
requirement - követelmény
interview - interjú
bomb - bomba
field - pálya
employment - foglalkoztatás, alkalmazására
loan - hitel, kölcsön
celebration - ünneplés, ünnepségre
the whole time - egész idő alatt
suspicion - gyanítom, gyanítod, gyanítottam
potential - potenciálját, potenciálunk, potenciálja
elbow - könyök
opinion - vélemény
out of town - távol van
fish - hal
you guys - srácok, tihozzátok, ti
photocopy - fénymásolat
social media - közösségi média
wrap - csomagol
row - sorba, soron
toilet - vécé
sweets - édességet, édességeket
unit - egység, mértékegység
throat - torok
bug - bogár
the mail - postába
cake - torta
spam - Spam, levélszemét
downtown - belváros
salespeople - eladóknak, eladó, eladók
patio - terasz
immigrant - bevándorló
after work - munka után
yoga - jóga
rice - rizs
confidence - bizalmukat
back pain - hátfájás
river - folyó
contest - verseny
vote - szavaz
truth - igazság
the internet - interneten
plane - repülő
technique - technika (mesterségbeli)
side - oldalsó, oldalon, oldali
trap - csapda
defeat - vereség, legyőznöd
every day - mindennap
peanut butter - mogyoróvaj
pen - toll
gender - nemek
football - amerikai foci
Wi-fi - WIFI
influence - befolyás
calendar - naptár
tank - üzemanyagtartály
hand - kéz
folk - nép
on sale - leárazott
whole body - teste, tested, testemben
application - jelentkezés
foot - lábfej
selfie - szelfi
waiter - pincér
beer - sör
folder - mappa
peace - béke, békét
chili - chilipaprika
milk - tej
universe - univerzum, világegyetem, világmindenség
version - változat
car - autó
vacation - szabadság
volume - térfogat, hangerő, kötet
plant - növény
colleague - munkatársad, kollégád, kollégámmal
weather - idő
hour - óra
midnight - éjfél
charity - jótékonyság
lease - bérlet, bérleti
fence - kerítés
podcast - podcast
thing - dolog, dolgot
olympics - Olimpia
load - terhelés, teher, rakomány
defense - védelem
car wash - autómosó
in person - személyesen
discount - kedvezmény
sculpture - szobor
groceries - élelmiszerek, élelmiszerekhez, élelmiszereimhez
the flu - influenza
murder - gyilkosság
tool - szerszám
difficulty - nehézség, gond, nehézsége
cost - kerül valamibe
tale - történet
girl - lány
statue - szobor
visa - vízum
library - könyvtár
conquer - meghódítsák
steak - steak
electricity - áram
bride - menyasszony
garden - kert
site - honlap, helyszín, hely
brochure - prospektus
paint - fest
appearance - megjelenés
problem - probléma
weekend - hétvége
all weekend - egész hétvégén
massage - masszázs
loss - veszteség
paper towels - papírtörlőt, papírtörlőket, papírtörlők
healthier - egészségesebb, egészségesebbnek
knives - kések, kés, késekre
camel - teve
retreat - elvonulás
unlock - kinyit
list - lista
ferry - komp
binder - mappa
lawyer - ügyvéd
necklace - nyaklánc
bike - bicikli
calm - nyugodt
dairy - tejtermék
rope - kötélen, kötélugró, kötél
curriculum - tanterv
half price - félár
transaction - tranzakció
committee - bizottság
shelter - menedékhely, menedék
lives - él, lakik
fever - láz
curtain - függőny
critic - kritikus
hole - lyuk
clinic - klinika
correction - javítást
goods - javak
measure - mér
fact - tény
trumpet - trombita
medicine - gyógyszer
divorce - válás
poetry - költészet, költői(es)ség
novel - regény
accomplishment - teljesítmény, teljesítményérzetet
shipping - szállítás
clue - nyom
paragraph - bekezdés
muscle - izmok, izom, izmot
broccoli - brokkoli
fast food - gyorsétel
superpower - szupererő
dentist - fogorvos
strategy - stratégia, stratégiája
health - egészség
rude - udvariatlan
paintbrush - ecset
bookstore - könyvesbolt
redo - újracsinál
eighties - 80-as évek
prevention - megelőző, megelőzés
fog - köd
pea - borsó
taste - íz, íze, megkóstoltad
war - háború
attack - támadás, roham
on mute - némítva
sheet - lap
s' - dolgozatainak, eredményeinek, táskáinak
laboratory - laboratórium
human - emberi, ember, emberi lény
wave - integet
parking - parkolás
question - kérdés
head - fej
refrigerator - hűtőszekrény
bathing suit - fürdőruhát, fürdőruha, fürdőruháról
production - termelés, előállítás
porch - veranda
wildlife - vadvilág
lab - laboratórium
corporation - vállalat, vállalattól, vállalatot
jury - zsűri, esküdtszék
reservations - helyfoglalást, foglalások, foglalásokat
monster - szörny
cream - tejszín
scene - jelenet
ability - képesség
sandy - homokos
bread - kenyér
ranch - tanyát
bone - csont
vitamin - D-vitamin, A-vitamin
argument - vita
misunderstand - félreért
lip - ajk
governor - kormányzó, kormányzónak
trust - bízik
baseball - baseball
salad - saláta
tomorrow night - holnap este
one of these days - egyik nap
repair - megjavít
today - ma
decorations - dekorációkat, díszek
collection - gyűjtemény
struggle - küzdesz, nehezen, küzdj
dirt - kosz
occupation - foglalkozás
agency - ügynökség
roll - görgesd, gördül, zsemle
concern - aggaszt, aggodalom, aggodalomra
month - hónap
seat - vécéülőke, ülőhely, ülés
garage - garázs
notebook - jegyzetfüzet
desk - íróasztal
hippie - hippie
announcement - bejelentés
flight - repülés, járatunk, repülőút
a ride - fuvart
crawl - mászik
wind - szél
calves - borjak
satisfaction - elégedettség
what color - milyen színű, milyen színűek
golf - golf
soap - szappan
motorcycle - motor
abs - hasizmaid
society - társadalom
poison - megmérgezni, méreggel, méreg
government - kormány, kormánya
calf - borjú
onion - hagyma
others - többieket, másoknak, többiekkel
good night - jó éjt
leak - vízszivárgást, szivárog
last night - tegnap este
act - cselekedet, tett, felvonás
hope - remél
a bit of - egy kis ……
compliment - bókot, bóknak, Bóknak
lion - oroszlán
album - album
bill - számla
roller coaster - hullámvasút
puzzle - kirakós
hurricane - hurrikán
disaster - katasztrófa
issue - gond, téma, kiadás (vmi kibocsátása)
obligation - kötelessége, kötelességet, kötelesség
continent - kontinens
route - útvonalat, útirány, útvonal
first class - első osztály
decline - csökken, hanyatlásának
hitchhike - stoppol
documentary - dokumentumfilm
track - pálya, nyomon
leopard - leopárd, leopárdot
drug - gyógyszer
microwave - mikrohullámú
at this point - ezen a ponton
spring - tavasz
cow - tehén
sugar - cukor
edit - szerkeszt
elevator - lift
highway - autópálya
yard - udvar
ice cream - fagylalt
cheers - egészségedre
drugstore - gyógyszertár
distance - távolság, táv
staff - személyzet
download - letölt
breakfast - reggeli
supermarket - szupermarket
cabin - faház, kabint, kabin
product - termék
piano - zongora
on the way to - irányába
sunglasses - napszemüveg
nail polish - körömlakk
hostel - ifjúsági szálló
logo - embléma, logó
all kinds of - mindenféle
budget - költségvetés
ski - síel
street - utca
order - rendel
mosquito - szúnyog
airplane - repülőgép
president - elnök
blender - turmixgép
spoil - romlott
dessert - desszert
trend - trend, irányzat
crime - bűncselekmény
bedroom - hálószoba
test - teszt
yourselves - te magatok, magatok, magatoknak
player - játékos
prescription - recept
paperwork - papírmunka
trunk - csomagtartó
half an hour - fél óra
memory - memória
newspaper - újság
thriller - thriller
dedication - elkötelezettségre, Elkötelezettséget, elkötelezettségüket
gum - rágógumit, rágógumimmal, rágógumival
insurance company - biztosítótársaság
exit - kijárat
doll - baba
rescue - menteni
army - hadsereg
target - célod, célokra, célunkat
world - világom, világnak, világ
project - projekt
heritage - örökség
great-grandson - dédunoka
observation - megfigyelés
bracelet - karkötő
potluck - batyus vacsi, batyus bál
potato - krumpli
charger - töltő
admission - belépés
energy - energia
journalist - újságíró
fridge - hűtő
reference - referencia
absent - hiányzik
before bed - lefekvés előtt
allowance - zsebpénzét, zsebpénzére, zsebpénzként
the truth - igazat
shape - alak, forma
locker - szekrény
place - hely
herb - gyógynövény, fűszer
school - iskola
anniversary - évforduló
employer - munkáltató
a variety of - különféle
research - kutatás, kutatásnak
knowledge - tudás, tudtommal
patience - türelem
owe - tartozik, tartozom
departure - indulás, távozás
material - anyag
taxi - taxi
race - verseny
celebrity - híresség
graduation - diplomaosztó
injury - sérülésből
superhero - szuperhős
dollar - dollár
post office - posta
pharmacy - gyógyszertár
radio - rádió
traffic light - lámpa
cushion - párna
response - válasz, reagálás, reakció
coat - kabát
soccer - foci
hot chocolate - forró csoki
device - eszköz, készülék
pool - medence
nap - szundítani, szundíts, szundít
vase - váza, vázát
finger - ujj
headline - címsor
behavior - magaviselet, viselkedés, magatartás
outfit - ruha
at school - az iskolában, iskolában, iskolába
exchange - vált
belongings - tulajdona, holmijaid
breakthrough - áttörés
mall - bevásárlóközpont
photography - fényképészet
guest - vendég
chapter - fejezet
permission - engedély, engedélyre, engedélyt
delivery - kézbesítés, küldemény, szállítmány
hike - túrázik
tip - borravaló
brain - agy
smell - szaga, illat, szaguk
makeup - smink
childish - gyerekes
basketball - kosárlabda
earache - fülfájás, fáj a fülem
the day after tomorrow - holnapután
of course - természetesen
as a child - gyerekként
pajamas - pizsama
bottle - üveg
meal - étkezésem, étkezésük, étel
quarter past - Negyed, negyed
ship - hajó
host - házigazda, házigazdájának
compromise - kompromisszum
group - csoport
in advance - előre
location - helyszín
mouth - száj
grape - szőlő
waiting room - váróterem
brick - tégla, téglaházakat
conditions - feltételek, körülmények
talent - tehetség
cartoon - rajzfilm
on TV - a tévében
floor - padló
tourism - turizmus
mechanic - szerelő
age - életkor
heart attack - szívroham
baby - baba
space - tér, hely, űr
cotton - pamut
no way - dehogy
reality tv - valóságshow
data - adat
in front of - előtt, elé
junk - szemetet
in charge - felelős, megbízva
exercise machine - edzőgép
couch - kanapé
leather - bőr
appreciation - elismerését
good old days - régi szép idők
club - klub
ma'am - asszonyom
diploma - diploma
century - évszázad
train station - vonatállomás
television - tévéje, tévét, televízió
the bar - a bárba
chore - házimunka
method - módszer
zipper - cipzár
dye - fest
director - rendező
in the past - A múltban
demand - követelés, kereslet, igény (vmire)
class - csoport
life - élet
beef - marhahús
road - út
bartender - bártender
bar - bár
suit - öltöny
decrease - csökken, csökkent
rock - rock
bad luck - balszerencse
musician - zenész, zenésznő, zenésznek
apology - bocsánatkérés
treatment - kezelés, gyógykezelés, bánásmód
justice - igazság
hail - jégeső
rumor - pletyka
on time - időben
cherry - cseresznye
bleachers - lelátónál, lelátó
geography - földrajz
trick - trükkhöz, trükköt, trükkje
weekday - hétköznap
approach - megközelíteni
apartment - lakás
article - cikk
writer - író
heart disease - szívbetegség
skin - bőr
pepper - bors
gas station - benzinkút
outline - vázlat
education - nevelés, oktatás, műveltség
door - ajtó
exhibit - kiállítást, kiállítását, kiállítás
bean - bab
suburbs - külváros
switch - lekapcsolod, kapcsol, kapcsoltátok
lesson - óra
debt - tartozás, adósság
engineer - mérnök
curfew - kijárási tilalom
gift - ajándék
salt - só
passion - szenvedélye, szenvedélyemet
stain - folt
mom - anya
permit - engedély, engedélyt
mosque - mecset
graduate - diplomát szerez
insect - rovar
up-to-date - friss, aktuális
passenger - utas
police - rendőrség
bear - medve
flashlight - zseblámpa
security camera - biztonsági kamera
darkness - sötétség
rap - rapet, rap, rapben
server - pincér
state - állam
in the mountains - a hegyekben
crash - baleset, összeütközés, összeomlás
ban - tiltani
dog - kutya
in pain - fájdalmam, fájdalomban
pill - tabletta
sunrise - napkelte, napkeltekor
pipe - cső
yikes - jaj, hűha
giant - hatalmas, óriási
wife - feleség
summer - nyár
attitude - hozzáállás
shoe store - cipőbolt
money - pénz
magic show - bűvészelőadás
battle - harc, csata, ütközet
hunt - vadászik, vadásznak
accident - baleset
potato chip - burgonyaszirom
grandkid - unokája
elephant - elefánt
spill - kiöntsd
advertisement - reklám
driver - sofőr
reply - válaszol
unkind - durva, barátságtalan
boss - főnök
video call - videóhívás
candy - édesség
singer - énekes
meeting - értekezlet
number - szám
fries - sült krumpli
picnic - piknik
midterm - félévi
text - üzenetet ír
pants - nadrág
over the weekend - a hétvégén
with cash - készpénzzel
person - személy
tent - sátor
relief - megkönnyebbülés
refund - visszatérítés
sunset - naplemente
bus station - buszpályaudvar
forest - erdő
winter - tél
plastic - műanyag
yours - az önöké, a tiétek, a tieid
idea - ötlet
next time - legközelebb
woods - erdő
perfume - parfüm
discussion - megbeszélés, vita
nightclub - éjszakai klub
a lot - nagyon
sea - tenger
battery - akkumulátor
folks - emberek
type - gépel
creature - teremtmény
handwriting - kézírás, kézírást
direction - irány
cotton candy - vattacukor
music - zene
control - befolyás vmi fölött, uralom vmi fölött, irányít
volunteer - önkénteskedik
game - játék
fiction - fikció
trash can - szemetes
size - méret
toe - lábujj
for sale - eladó
goodbye - viszontlátásra
pilot - pilóta
tradition - hagyomány
fun - szórakoztató
squats - guggol, guggolások
bull - bika
horror - horror
fire department - tűzoltóság
cab - taxi
appetizer - előétel
fitting room - próbafülke
purse - retikül
tie - nyakkendő
nightlife - éjszakai élet
attention - figyelem, figyeljünk
wall - fal
advice - tanács
mayor - polgármester
sticker - matrica
probation - próbaidő
chimney - kémény, kéményre
therapist - terapeuta
crew - személyzet
jump - ugrál
engine - motor
fortune - vagyonba
comment - megjegyzés
earth - A Föld, föld
on top of - a tetejére, -on/-en/-ön/-n (rajta), a tetején
guitarist - gitáros
dish - edény
utilities - közüzemi szolgáltatások, közművek
grill - grillezik
tape - szalag
audition - meghallgatás
the moon - a Holdat
wrist - csukló
lung - tüdőproblémái, a tüdőre
room - hely, szoba, üres hely
clothing - ruházat, ruházati, ruhára
at work - munkában, a munkahelyen, munkahelyen
sister - lánytestvér
degree - diploma
chef - séf
surgery - műtét
portrait - portré, portréja, portrét
child - gyerek
document - dokumentum
benefits - hasznok, előnyös/kedvező hatások, jótékony hatások
custom - szokás
gas - benzin (mint üzemanyag), gáz (kémiailag)
grade - jegy
construction - (meg)építés, építkezés, megépítését
bat - denevér
comedy - vígjáték
granddaughter - unoka
mice - egeret, egerektől, egerek
copy - másol
tornado - tornádó
process - folyamat, folyamathoz
college - főiskola
resort - üdülőhely, nyaralóhely
league - bajnokság, liga
none of - egyik
hobby - hobbi
shop - vásárol
uncle - nagybácsi
resolution - fogadalom
cap - sapka
shade - árnyék
sports - sportokról, sportokban, sportok
day - nap
respect - tisztel
yuck - fúj, fuj
weight - súly
the sun - a nap, a napot
baggage - csomag
heat - fűtés
beverage - ital
spreadsheet - táblázatot
enemy - ellenség, ellenségem
cheer - szurkol
ambulance - mentő
tomato - paradicsom
businessman - üzletember
coworker - munkatárs
ruin - tönkretenné, elrontaná
pineapple - ananász
good morning - jó reggelt
afternoon - délután
lottery - lottó
carpet - szőnyeg
restaurant - étterem
office - iroda
style - stílus, stílusát, stílusa
line - sor
entertainment - szórakozás
stone - kő
subway - metró
bond - kötvény
address - cím
poverty - szegénység
partner - társ
pond - tó, halastavat, tavukat
what kind of - milyen
truck - teherautó
indoors - beltérben, bent
time off - szabadidő
police officer - rendőr
compare - összehasonlít
availability - elérhetőség
princess - hercegnő
surprise - meglepetés
glasses - szemüveg
magazine - folyóirat
rehearsal - próba
city - város
racket - ütő
sentence - mondat
feet - lábfejek
zone - zóna, övezet
movie theater - mozi
parade - parádé
dorm - kollégium
chicken - csirkehús
male - hím
dresser - komód
glove - kesztyű
victim - áldozat
hammer - kalapács
kindergarten - óvoda
shelf - polc
identification - igazolvány
stem - szár
math - matek
robot - robot
phone number - telefonszám
dust - port töröl
topic - téma
surroundings - környezet
riskiest - legkockázatosabb
trash - szemét
weapon - fegyver
contact - felveszi a kapcsolatot
with a check - csekkel
whale - bálna
ladder - létra
driver's license - jogosítvány
wine - bor
art - művészet
tennis - tenisz
man - férfi
deck - fedélzet
washing machine - mosógép
website - webhely
parking space - parkolóhely
principal - igazgató
activity - tevékenység
corner - sarok
scouts - cserkészek
press - sajtó, megnyom, nyomda
summertime - nyáron
instructor - oktató
sofa - kanapé
receptionist - recepciós
wristband - karszalag
reschedule - átütemez
blood - vér
bus - busz
deer - szarvas
reaction - reakció
last name - vezetéknév
essay - esszé
sausage - kolbász
values - értékek
ingredient - hozzávaló
when in doubt - kétség esetén
husband - férj
envy - irigylem
patient - páciens
university - egyetem
estimate - becsülték, becsülte, becsülted, becsülni
countryside - vidék
drank - ivott / ittak stb., ivott, itta
band - zenekar
best friend - legjobb barát
email - e-mail
role - szerep, szerepet, szerepe
kitchen - konyha
grandfather - nagyapa
toilet paper - vécépapír
gift card - ajándékkártya
brand - márka
trail - ösvény
wool - gyapjú
none - semelyik, semennyi, közületek senki nem ...
frame - keret
woman - nő
snow - hó
at the moment - jelenleg
warmth - melegség
by the way - egyébként
bag - táska
panic - pánikolni, pánikba, bepánikoltatni
great-grandmother - dédnagymama
in other words - más szavakkal
reputation - híre, hírnév
shift - műszak
glass of water - pohár vizet
brake - fékpedál, fékpedálom, fékpedálja
error - hiba
great-grandparent - dédszülő
gang - banda, macskabanda
knee - térd, térdem
diving - búvárkodás, merülés
gardener - kertészt, kertésszel, kertész
chip - csipsz, burgonyaszirom
shoe - cipő
aircraft - repülőgépek
friend - barát
sale - eladás
medalist - bronzérmes, aranyérmes, ezüstérmes
flip-flop - strandpapucs
spotlight - reflektor
storage - tárolóhely, tárolószoba
drawer - fiók
conclusion - konklúzió, következtetés
daylight - nappal, nappali fény
vet - állatorvos
transfer - átutal
chocolate - csoki
guys - srácok
detail - részlet
week - hét
cracker - sós keksz
candle - gyertya
bed - ágy
union - szövetség, egyesület, unió
town - város
opera - opera
vision - látás, látomás
myth - mítosz
halftime - félidő
powder - púder, por
stapler - tűzőgép
silverware - ezüstkészlet
flour - liszt
inch - hüvelykes
lyrics - dalszöveg
law - törvény
story - történet
security - biztonság
tights - harisnyát, harisnya
exam - vizsga
form - űrlap
fan - szurkoló
fifties - ötvenes évek
gold - arany, aranyszínű
convince - meggyőzni
nail - köröm
skill - készség
figure - figura, alak, ábra
from home - otthonról
handcuffs - bilincs
in the future - a jövőben
fall - ősz
the rest - a többi, a maradék
increase - (meg)növel, növelnünk
risk - kockázat, kockázatot
infection - fertőzésem, szemfertőzésén, fertőzés
aunt - nagynéni, nagynénim, nagynénémet
trainer - edző
checkout - pénztár
vehicle - jármű, járművem
pig - disznó
cereal - gabonapehely
share - megoszt
airline - légitársaság
on vacation - vakáción
mother-in-law - anyós
future - jövő
rainbow - szivárványszínű, szivárvány
gallon - gallon
hundreds - százak
deal - megállapodást, megegyezés, megállapodás
defendant - vádlott
file - fájl
waterfall - vízesés
thief - tolvaj
station - vonatállomáson, vonatállomás, buszpályaudvart
bad guy - rosszfiú
toothbrush - fogkefe
occasion - alkalom, apropó
interest - érdekli
channel - csatorna
cloud - felhő
toothpaste - fogkrém
table - asztal
all the time - mindig
appliance - eszköz, készülék
in bed - ágyban, az ágyban, ágyba
in love - szerelmes
love - szeret
glass - üveg, pohár, poharat
dad - apa
fingerprint - ujjlenyomat
blinds - redőnyt
violence - erőszak
gear - felszerelésre, felszerelésem, felszerelést
debit card - bankkártya
award - díj
rung - csörgött
tax - adó, adót
accusation - vád, állításod
headlight - fényszóró
jail - börtön
conference - konferencia, konferenciára
rush - sietünk, sietnek, kisietünk
industry - ipar, iparág
software - szoftver
stomach - gyomor
tournament - verseny
detective - nyomozó
passport - útlevél
depart - felszállnak, elindul, indul
therapy - terápia
embarrassment - szégyen
just a minute - egy pillanat
portion - adag
report card - ellenőrző könyv
supplies - kellékre, kellékeket, kellékekre
for the first time - először
elect - megválasztottuk
strawberry - eper
punk - punk
lunch - ebéd
case - tok
smoothie - turmix
oil change - olajcsere
toy store - játékboltba, játékbolt
customer service - ügyfélszolgálat
machine - gép
agenda - napirend
carve - faragnak
responsibility - felősség
on the contrary - sőt
store - bolt
lightning - villám
overtime - túlórában, túlóra, túlórázni
phone - telefon
tongue - nyelv
accommodations - szállás
babysit - gyerekekre vigyáz
galaxy - galaxisunkból, galaxisunkban, galaxisban
savings - megtakarítások
chat - beszégetés
my name is - a nevem
internship - gyakornokság, szakmai gyakorlat
script - forgatókönyv
bullet - golyót
shore - part
goosebumps - libabőr
experiment - kísérlet
politics - politika
winner - győztes
disease - betegség, betegsége
privacy - magánélet
liar - hazug
politician - politikus
food - étel
noon - dél
language - nyelv
rule - szabály
movie - film
basement - pince
round-trip - retúr, menettérti
wallet - pénztárca
of course not - természetesen nem
reception - recepció, fogadás, recepciónál
horse - ló
toenail - köröm, lábköröm
edge - szegély, szél (vmi széle), perem
horseback riding - lovaglás
an a - ötöst
clap - tapsolnék
economy - gazdaság
event - esemény
knot - csomót, csomó
frost - dér
beginner - kezdő
sensation - érzés
grandmother - nagymama
farmer - állattenyésztő, farmer, gazda
morning - reggel
lamp - lámpa
on my way - útközben
subtitles - felirat
roast - süt
duck - kacsa
grandparents - nagyszülőm, nagyszülők, nagyszüleinknek
percent - százalék
virtual reality - virtuális valóság
tv - tévéje, tévét, televízió
destination - úti cél
tear - elszakad
poet - költő
team - csapat
on stage - színpadon
symptom - tünet
effect - mellékhatást, hatás, hatásuk
range - hegylánc, tartomány
quiz - kvíz
evening - este
container - tartály, edény, tartó
studies - dolgozószobák, tanulmányaimat, tanulmányok
shirt - póló
sweat - megizzasszalak, izzad
travel - utazik
bargain - alkalmi vétel, alku
athlete - sportoló
boy - fiú
equipment - felszerelés
nature - természet
poster - plakát
fee - díj
vacuum - porszívózik
hero - hős
audience - közönség, hallgatóság
dinner - vacsora
sweatshirt - melegítőfelső
workout - edzés
shadow - árnyék
refreshments - frissítők
silk - selyem
board game - társasjáték
blanket - takaró
cider - almabor
flavor - íz
willpower - akaraterő
page - oldal
receipt - nyugta
friendship - barátság
price tag - árcédula
item - termék
ones - azok
firefighter - tűzoltó
grandson - unoka
advantage - előny, előnye
earring - fülbevaló
handkerchief - zsebkendőre, zsebkendőt, zsebkendő
rush hour - csúcsforgalom
opponent - ellenfél
spaceship - űrhajó, űrhajóban, űrhajón
music video - videóklip
children - a gyerekek, gyereket, gyerekek
disagreement - nézeteltérése, vitánk, vita
border - határ, szegély, határt
hair - haj
storm - vihar
spoon - kanál
thieves - tolvajok
in case - ha véletlenül, hátha, ha netán
flower - virág
ketchup - ketchup
captain - kapitány
card - üdvözlőkártya
transportation - szállítás(i), közlekedés(i), közlekedési
country - ország
adventure - kaland
boyfriend - barát
playground - játszótér
theater - színház
courage - bátorságot, bátorságom
dominoes - dominó
roommate - szobatárs
year - év
church - templom
religion - vallás, vallású
spa - wellness, gyógyfürdő
directions - irányok, útmutatások, útbaigazítást
quarter to - háromnegyed
witness - tanú
learner - nyelvtanuló, tanuló
super bowl - Super Bowl
in-laws - házastárs szülei
adult - felnőtt
determination - elszántságát, kitartásod, elszántság
vegetable - zöldség
congratulations - gratulálok
recycle - újrahasznosít
common sense - józan ész
shoulder - váll
pie - pite
employee - alkalmazott
dozen - tucat
coffee - kávé
cover letter - motivációs levél
balance - egyenleg
seventies - hetvenes évek
grab - megragad
achievement - teljesítmény, eredmény
monument - műemléke, műemlék, műemléket
procedure - eljárás
clothes - ruhák
cliffhanger - függővég
supper - vacsorát
corruption - korrupció
the news - a hírek
wellness - wellness
villain - gonosztevő
cash - készpénz
cycle - körfolyamat, ciklus, körforgás
population - népesség, lakosság, népessége
plan - terv
presentation - prezentáció
fire - tűz
whiteboard - tábla
years old - éves
exercise - edz
painter - festő
manager - menedzser
information - információ
benefit - juttatás
factory - gyár
representative - képviselő
delay - késik
backyard - hátsó udvar
gala - gála
plumbing - vízvezeték
rain - esik
commute - ingázáshoz
luggage - csomag
sort - fajta
capacity - kapacitással, kapacitású
opportunity - alkalom, lehetőség
charm - bája, bájának, bájosak
angel - angyal
cruise - hajóút
cemetery - temető
democracy - demokrácia
honeymoon - nászút
in pairs - párban
frog - béka
king - király
strength - erő
thunder - villám
attempt - megkísérel, próbálkozás, próba
firework - tűzijáték
inconvenient - kellemetlen
laundromat - mosoda
tire - gumi
pet - házikedvenc
update - frissítés
signature - aláírás
nonsense - nonszensz
on account of - következtében, miatt
these ones - ezeket
greet - köszönni
on purpose - szándékosan, direkt
change of clothes - váltás ruhára, váltás ruhát, váltás ruha
good luck - sok szerencsét
waste - pazarolja
in a relationship - kapcsolatban
campaign - kampány
speech - beszéd
pedal - pedál, fékpedál, fékpedálom
photographer - fényképész
in the evening - este
body - test
cuisine - konyha
traffic jam - dugó
ground - föld, talaj
teenage - kamasz
bunch - csomó
schedule - menetrend
apartment building - lakóépület
seafood - tenger gyümölcsei
credit - hitel
rabbit - nyúl
mile - mérföld
possibility - lehetőség, lehetőségünk
photograph - fénykép
bubble gum - rágógumi
investment - befektetés
butter - vaj
bed and breakfast - szállás reggelivel
in the rain - az esőben
election - választás
people - nép, emberektől, ember
circus - cirkusz
leader - vezetője, vezető, vezetővel
cell phone - mobiltelefon
duty - kötelességed
mess - rendetlenség
metal - fém
option - lehetőség
worker - alkalmazott
chance - lehetőséget, alkalmat
alternative - alternatíva, választási lehetőség, másik lehetőség
mine - az enyémet, enyéim, enyémet
total - összeg
bronze - bronzszínű, bronzérem
referee - (sport) bíró, bíró
client - klienssel, kliens, kliensed
accountant - könyvelő
attachment - melléklet, csatolmány
laundry - ruhák
way - út
peanut - mogyorót
humidity - nedvesség
milestone - mérföldkő
traffic - forgalom
philosophy - filozófia
wonder - csodálkozni, tűnődöm
cattle - szarvasmarha
promise - ígéretet, megígérsz
suitcase - bőrönd
thousands - sok ezer, ezrek, ezreket
alcohol - alkohol
certificate - tanúsítvány, bizonyítvány
window - ablak
hotel - szálloda
land - föld, leszálltok, leszáll
damage - veszteség, kár, károsodás
personality - (vki) természete, személyiség
video game - videójáték
rug - szőnyeg
at night - éjszaka
bowl of soup - tál leves
tunnel - alagút
knife - kés
credit card - hitelkártya
culture - kultúra
soil - talaj
power - teljesítmény (gépé), áram, (átv) erő
camp - kempingezik
assignment - feladat
underwear - alsónemű
sunlight - napfény
community - közösség, közösségi
dodgeball - kerülgetőlabdát, kerülgetőlabda
soldier - katona
thunderstorm - zivatar
yawn - ásít
student - diák
clock - óra
sandal - szandál
s'mores - s'mores
illusion - illúzió, illúziót, illúziónak
company - cég
laptop - laptop
festival - fesztivál
raincoat - esőkabát
swimmer - úszó
light - világítás, lámpát, könnyű
session - edzés, foglalkozás
biology - biológia
couple - pár
meditate - meditál
pound - font
challenge - kihívás
beauty - szépség
code - kód
explore - felfedez
passport control - útlevélellenőrzés
parking lot - parkoló
piece - szelet
men - a férfiak, férfiakat, férfiak
drama - dráma
lots of - rengeteg, sok
song - dal
owl - bagoly
day care - napközi
vocabulary - szókincs
fashion - divat
priority - prioritásunk, prioritás, prioritásnak
letter - levél
ground floor - földszint
in my opinion - szerintem
sand - homokos, homok, homokot
quality - minőség, tulajdonság, kvalitás
palace - palota, palotát
business - üzlet
leftovers - maradék
shuttle - űrrepülőgép, transzfer
mail - levél, elküld, mail
preparation - készülés
yesterday - tegnap
lifetime - élete
t-shirt - póló
suggestion - javaslat
blouse - blúz
