two - kettő
twenty ten - húsz tíz
two thousand seven - kétezer-hétben, kétezer-hetes
forty - negyven
twenty fifteen - kétezer-tizenötben, kétezer-tizenöt
thirty-seven - harminchét
six - hat
eighty - nyolcvan
eighteen - tizennyolc
fifty - ötven
two thousand three - kétezer, kétezer három
seven - hét
hundred - száz, százast
fifteen - tizenöt, tizenötkor
four - négy
thirty - harminc
one - egy
thousand - ezer
seventy - hetven
eight - nyolc
ninety - kilencven
twenty - húsz
seventeen - tizenhét
ten - tíz
eighteen seventy - ezer nyolcszáz hetvenben, ezer nyolcszáz hetven
forty-five - negyvenöt
one of the - az egyik ...
nineteen - tizenkilenc
thirteen - tizenhárom
billion - milliárd
eleven - tizenegy
three - három
million - egymillió
nineteen ninety - ezerkilencszázkilencvenben
twenty-one - huszonegy
eighteen ninety - ezer nyolcszáz kilencvenben
nine - kilenc
fourteen - tizennégy
five - öt
nineteen sixty - ezerkilencszázhatvan, ezerkilencszázhatvanban
twelve - tizenkettő
