what - mi
herself - önmagát, saját maga, önmaga
anything - bármi, valami, semmit
her - őt, benne, neki
which - melyik, hányadik, amit
me neither - Én sem
you'll - leszel, fogsz, kapsz
them - nekik, azokat, őket
another - még egy
what if - mi van (akkor) ha
who's - Kit, Ki
she - ő
everything - minden
he's - ő
what to - mihez
anybody - senki, bárki, senki sem
these - ezek a, ezeket az, ezeket a
some of - néhányra, néhány részét, egy részét
i'll - fogok
something - valami
it's - ez, van
he'll - fogja, tesz, lesz
we all - (mi) mindannyian, (mi) mind, (mi) mindnyájan
there has been - történt
whichever - bármelyik, akármit
she's - ő
any - semelyik, bármilyen, bármelyik
their - az ő, őket
himself - őt magát, önmaga, önmagát
the - az, a
anyone - bárkivel, valaki, senkivel
he - ő
him - ellene
themselves - maguknak, magukra, magukat
any of - egyet sem
everybody - mindenkit, mindenki, mindenkinek
myself - önmagam, magam, magamat
its - ...a/e/ja/je, a/az...-a/e/ja/je
someone - valaki
all of - az összes
this - ez, ez a, e
itself - öt/azt magát, maga, önmagát
those - azok a, azok, azokat
every - minden
each - minden
they're - Ők, Őket
an - egy
it'll - fog, lesz
nothing - semmi
what is - mi, mit
everyone - mindenki
me - nekem, én, engem
us - nekünk, minket, USA
yourself - magad, magaddal, magára
what's - mi van, mi
bookshelf - könyvespolc
a - egy, ötöst, A
whatever - bármilyen, akármi
who - ki
they'll - lesznek, tesznek, fognak
we - mi, nekünk
any longer - már, tovább
they - ők
nobody - senkinek, senki, senki nem
i'm - vagyok
that's why - ezért
i am from - származom
there - oda
me too - én is
I - én
it was - volt
you - te
who is - kik vannak ..., ki
what a - micsoda ………!
this is - ez
we're - vagyunk, leszünk
somebody - valakire, valakinek, valaki
some - valami, valamennyink, egy kis
it - azt, ez, az
ourselves - magunk, magunkat, magunknak
what's up - mi a helyzet
we'll - majd, leszunk, fogunk
you're - vagy
what about - mi a helyzet ………vel?
your - Ön, sportod, ti
she'll - fog, megy, lesz
his - övé
there have been - volt (hangsúlyosan), volt
our - mi
whoever - Akit (is) ...
all - összes
my - az én
it is - ez, van
that's - Ezért, az, Az
both - mindketten, mindkettő, mindkét
