how - hogy
why - miért
how are you - hogy vagy
despite - annak ellenére
how's - hogy van
how about - Mi lenne
because - mert
although - bár, noha
if - ha, -e, e
how about you - és te
till - amíg
where's - Hol van
except - vminek a kivételével, vmitől eltekintve, kivéve
whether - hogy
how long - mennyi ideig
unless - hacsak
while - amíg
why don't - miért nem
how did - hogy
that - azt, az az, amit
wherever - akárhol, bárhol, bárhová
when - mikor
where - hol
so that - (azért,) hogy, hogy
since - minthogy, mivel, óta
where is - Hol található, Hol van
because of - miatt
if you can - ha tudod
though - noha, habár
how often - milyen gyakran
whenever - akármikor
