brought - hozott, (ő) hozott, elhoztad
broke - eltört, eltörtek, törte
see - lát
allow - (meg)enged
confirm - megerősít
fly - repül
there were - volt
believe - hisz
put away - eltesz
heal - meggyógyul, gyógyulás
repeat - ismétel
hold - tart
determined - eltökélt
fill out - kitölt
post - bejegyzés
introduce - bemutat
scarf - sál
have - van
delighted - örültek, elragadtatva, örvendek
advertising - reklámozás
plan to - tervem hogy, tervem, hogy
inspiring - inspiráló, Inspiráló
gotten - lett, megkapta, szerzett
break down - elromlott
win - nyer
prefer - jobban szeret
answer - válasz
meant - szándékozott, akarta mondani, jelentett
if you like - ha szeretnéd
click on - rákattint
born - született/megszületett
meet up - találkozunk
get dark - besötétedik
done with - kész van vele
have a good day - szép napot
fallen - lehullott, kidőlt, elesett
knowing - tudás, tudva, tudását
swim - úszik
scrambled eggs - tojásrántotta
concerned - aggasztott
named - hívják
stand - áll
look up - megnéz
taken - elvitt(ék), elvett(ék)
towel - törülköző
seatbelt - biztonsági öv
reveal - felfedje, felfedni
publish - kiadni, közzétenni, közzéteszem
let - engedett, hagy, hagyott
rearrange - átrendez
certified - tanúsítványra, tanúsítvány, tanúsítványt
create - (el)készít, (meg)alkot, létrehoz
fight - harcol, vita, harc
push - tol
submit - beadnunk, adták be, beadtad
listen - figyel
propose - javasol
got - szerezte, besötétedett, bejutottam
see you later - viszlát később
chew - rágj, rágógumit, rágok
encourage - bátorítanunk
agree - egyetért
predict - előre jelezni, megjósolni
return - visszavisz
can't stand - ki nem állhatja
borrow - kölcsönkér
go out - kimegy
mix - összekever
voicemail - hangposta
practice - gyakorol
tablecloth - asztalterítő
worried - aggódónak, aggódtál, aggódom
adapt - alkalmazkodni
relaxing - relaxáló
destroy - lerombol
i heard - hallottam
recognize - megismertem, megismersz, megismer
bored - unatkozó
lead - vezetni, vezető, vezesse
they say - mondanak
scared - ijedt
i'd love that - szeretném
hidden - elrejtve
bled - vérzett
limited - korlátozott
annoy - idegesítem
haven't - nem
blew - kifújta, elfújta
would you like to - szeretnéd, szeretnél
lost - elveszett
qualified - képes, alkalmas
stressed - stresszes
fall down - leesik
lend - kölcsönad
guess - kitalál
did not - nem
write - ír
sightseeing - városnézés
stretch - nyújt
put on - felvesz
belong to - tartozik
invite - meghív
appear - megjelenik, látszanak, tűnik vmi(lyen)nek
push-up - fekvőtámasz
crowded - zsúfolt
cover - borító
wish - kívánság, kíván (vkinek vmit)
stressed out - stresszes
shot - ital
kill - öl
compete - versenyez
warning - figyelmeztetem
spider - pók
get off - le, szállnak le, leszállnak
organize - rendbe tesz
sound - hangja, hang, hangzik
look like - úgy néz ki, mint
muffin - muffin
break - eltörtem, törtem, törted
mean - ért
threaten - fenyeget, megfenyegeti
stay away from - távol fogok maradni, távol kellene maradnunk, maradjunk távol
pack - csomagol
sang - énekeltünk, énekelt, énekeltem
take a tour - túrára megy
kicked - rúgta
don't forget to - ne felejtsétek el, ne felejtsd el, ne felejts
forget - elfelejt
sauce - szósz
boil - forrni, forralni
let's - Tartsunk, Csináljuk, Menjünk
told - mesélt, elmeséltem, meséltünk
had to - kellett
wait - vár
wanted - akartak, kértek, akartunk
announce - bejelent
packed - csomagoltam, bepakolta, csomagoltak
nice to meet you - Örülök, hogy
shown - megmutatta
care - gondoskodás, ellátás, törődés
torn - szakadt
react - reagált
love to - szeretném
object - tárgy
train - vonat
raise - fizetésemelés
show - műsor
hire - felvenni, fogadjak, fogadd
i'd like a - Szeretnék egy
go home - hazamegy
do the dishes - mosogat
withdraw - kivesz
flown - repült
relax - relaxál
attend - részt vesz
disgusting - undorító
how's it going - hogy mennek a dolgok
talented - ügyes, tehetséges
drums - doboknál, dobot, dobokat
make up - kibékül
became - vált, lett, lettek
think of - gondol vkire/vmire
pray - imádkozik
rest - pihen
maintain - fenntartani
assume - feltételez, feltételezni
root for - szurkol
endangered - veszélyeztetett
forgot - elfelejtették, elfelejtette, felejtettem
ridden - lovagolt, lovagoltam
seated - leültetve
throw - dob
shocked - döbbent
thank you - köszönöm
grow - nőj, termeszteni, nősz
pass away - elhuny, huny el
consider - fontolóra/figyelembe vesz, (meg/át)gondol, tart (vminek)
communicate - kommunikál
promote - előléptetni
sell - árul
thought - gondolt (vmire), gondolkodott (vmin), (azt) hitt(em/ed/e)
thinking of - gondolkodtam rajta, gondolkodom, gondolkodsz rajta
canceled - lemondva, elmarad, törölt
starving - éhező
shook - rázott
afford - megengedheti
stand up - feláll
regarding - vonatkozóan, kapcsolatban
remind - emlékeztet
look for - keres
taught - tanítottunk, tanította, tanított
forgotten - elfelejtett, felejtettem
crowd - tömeg
cave - barlang, barlangból
injure - megsérül
step - lépés, (mi) lépünk, lépcsőfok
claim - állítja
lie down - lefekszik
hanging - lógni, akaszt
teach - tanít
disagree - nem ért egyet
rugby - rögbi
put - tesz
lift - emel
click - kattints, kattintson, kattinthatsz
fasten - becsatolni
suffering - szenvedés, szenved
piercing - piercing
go shopping - vásárolni megy
grown - kinőtt
visit - meglátogat
keep - tart
play the - játszani
do you need - szükséged van ...?
written - megírta, írva
begin - kezdődik
keep fit - fitten tartja magát
pleased - elégedett
require - igényel
itch - viszket
rewarding - jutalmazó
carry - visz
classified - titkosított, titkosította
alternate - alternatív
read - olvas
hurt - megbántották, fájni, fáj
have to - kell, szükséges
see through - átlát
cancel - lemond
solved - megoldotta
stay - tartózkodik, maradtok, maradnom
allowed - engedélyezett
omelet - omlett
kiss - csók
ask for - kérni
known - tudta, ismerte
surfer - szörfös
welcome to - üdvözlünk a
go through - átmenni
get in - beszáll
yell - üvölt
appreciate - értékelik
respond - válaszol, válaszoljak
climb - mászik
cross - átmegy
suppose - feltételezem
accuse - vádolod
worry - aggódik
boost - fokozni, növelni
fought - harcolt
get back - visszaér
postpone - elhalaszthatjuk
closed - zárva
progress - haladás
apologize - bocsánatot kér, elnézést kérni
get - odaérek, jutni, eljut vhova
accept - elfogad, fogadnia, elfogadnak
cast - gipsz
i don't think so - nem hiszem
closet - szekrény
disappoint - csalódást okoz
score - eredmény
avoid - kerül, kerülöm, kerüld
did you say - mondtad
won - nyertek, győzött, (meg/el)nyert
knew - (ő) tudta, tudta, ismert
watch - megnézem, megnézünk, nézzük meg
fall asleep - elalszik, elaludt, elalszanak
strike - sztrájk, munkabeszüntetés
move out - kiköltöznek
convinced - meggyőzte
follow - követ
miss - kihagy
expect - elvárd, várni, számít
pay attention - figyel
hesitate - habozz
weigh - nyom, mérem
cook - főz
lemon - citrom
take care of - gondoskodnia, gondoskodik, vigyázzatok
heard - hallott, meghallottad
thinking - gondolkodik, vkire gondolás, gondolkodás
if you want - ha akarod
laugh - nevet
discuss - beszélget
recommend - javasol
have a seat - foglalj helyet
earn - keres
pear - körte
see you tomorrow - viszlát holnap
watch out - vigyázz
prepared - felkészült
following - követ, következők
hide and seek - bújócska
located - megtalált, található
grilled - grillezett
buy - vásárol
neighboring - szomszédos
turn in - bead
speak - beszél
nightmare - rémálom
haunted - kísértetjárta
run - fut
handle - fül, füle
related - kapcsolódó
racing - versenyezni
move into - beköltöznek, költöznek be
reach - belenyúlt, jutni, ér
spoke - beszélt
do - tisztítsuk, megcsinálod, csinálnom
save - félretesz
including - felvesz, tartalmaz, ide/bele/hozzászámít
you know - ismersz, ismertek, tudod
give up - feladja
campfire - tábortűz
remember - emlékszik
impress - lenyűgözd
found - megtalálta, találtuk, talált
turn - elfordul
survive - túléljük, túlélni, túléljek
cheek - orca
arrest - letartóztatás
go to sleep - aludni megy
make - készít
score a goal - gólt szerez
move away - elköltöznek
succeed - sikerül
ballet - balett
fork - villa
enjoy - élvez
register - iratkozni, feliratkozik, jelentkezzen
leave - indul
i'd love - Szeretnélek, Szeretnék, Szeretném
fold - összehajtani, hajtogatta
warn - figyelmeztetem
blow - fúj
divide - elosztjuk, megosztani
lit - felgyújtottam, gyújtott, meggyújtottam
fell down - leesett, leestek
feel - érez
going - megy, elmennek, járást
recover - felépül, meggyógyul, visszaszerez
bury - eltemetni, eltemetsz, eltemesse
adjust - alkalmazkodni, alkalmazkodniuk
graduate from - diplomázzak
try to - próbáld meg, megpróbálom, próbálunk
rise - növekedés, emelkedés, emelkedést
dedicated - elkötelezettek, elkötelezettebb, elkötelezettséget
gardening - kertészkedés
gather - gyűlnek
cure - gyógymód
concentrate - összpontosítani
clogged - eltömődött
find - talál
would like to - szeretne
get married - összeházasodik
have a headache - fáj a feje
popcorn - pattogatott kukorica
replace - pótol
hang out - lóg
keychain - kulcstartó
does - tesz, nem
try - megpróbál
dehydrated - kiszáradt
set - készlet, üdvözlőkártyakészletet, tűzök
punish - büntet
pick - választ
saw - látott, megláttuk
hors d'oeuvres - előételek
snore - Horkol, horkoló
feeling - érzés
vanish - eltűnik, tűnt el
knock - kopogj
cheat - csal
guarantee - garancia, garantáljuk, garanciát
ran - futottam, odafutott, vezettem
pull-up - húzódzkodás
don't - nem, ne, nincs
asked - megkérdezte, kérdezte, kért
terrified - rémült
arrive - érünk, odaértél, ideérni
end up - végül
made of - készült
take place - lesz, történik
change - kicserél
upbringing - neveltetésed, neveltetésem, neveltetése
get lost - eltévedtem, eltévedtél, eltévedni
misleading - félrevezető
squash - tök
pick up - felvesz
relieved - megkönnyebbült
remove - eltávolítani
fate - sors
catch - elkap
check out - kijelentkezik
negotiate - tárgyalj, megtárgyalj
recycling - újrahasznosítás
hang - akasztod, akasztotta, akasztja
suspend - felfüggeszt
split - szétszakadt, eloszt
divorced - elvált
appealing - vonzó
can't wait - alig várom
thank - megköszön
pollute - szennyezni
outgoing - társaságkedvelő
pay attention to - figyeljen
broken - tönkrement
look out - kinézek
thank you for - Köszönöm, hogy, Köszönöm
winding - kanyargós
smell bad - rossz szagú
restore - helyreállíthatnánk, helyreállítom, helyreállítasz
provide - biztosít, nyújt, nyújtanod
explain - magyaráz
take a walk - sétál
has - neki megvan, eszik, áll
wait in line - sorban állni, sorban álljak
come on - gyerünk
doesn't - nem
would have - -t volna (csinált volna)
well-known - ismert
worn - viselt, kopott
go fishing - horgászni megy
understood - megértette, értetted, értett
drop - leejt
get dressed - felöltözik
clown - bohóc
trekking - túrázás
grew - nőtt
stir - keverd
housewarming - házavató
go back - menjetek vissza
upgrade - frissítés
concerning - aggasztó
encounter - találkozhatunk, találkoztok, találkozunk
take off - levesz
venue - helyszín
search for - keresem, keresik
tray - tálca
fountain - szökőkút
recipe - recept
eat - eszik
offer - felajánl
can you believe it - el tudod hinni
find out - megtud
shaken - rázott
take a flight - repülővel megy
mention - említ
left - felejtette, távozott, elment
looking - néz, utánajártál
beginning - kezdet
decide - dönt
stand up for - kiállok
realize - rájön
take a look - nézni
pose - pózol
intend - szándékoztam, tervezem
done - tett, csinált, végeztünk
crack - repedés
solve - megold, megoldani
frightened - megijedt
blindfolded - bekötött szemű, bekötve, bekötött
can make it - el tud jönni, el tudsz jönni
thank goodness - hála isten
get a virus - elkap egy vírust
tailgating - autós piknikezés, parkolóban csomagtartóból ivás
sat down - leült
fare - viteldíj
seem - tűnik
move - költözik
throw away - eldob
missing - eltűnt
wondered - csodálkoztak, gondolkodtam, csodálkozott
hang up - felakasztani, akasztja
said - mondott, mondta, szólt
continue - folytat
grounded - szobafogságra
don't care - érdekelnek, érdekel
shower - zuhanyzó
describe - leír
start - kezd
charge - feltölt
canyon - kanyon, kanyonba, kanyonban
buckle - becsatolni
sneeze - tüsszent
don't worry - ne aggódj
give - ad
spooky - ijesztő
spent - töltötték, elköltöttünk, töltöttek
seen - látta
meet - találkozik
learn - tanul
try on - felpróbál
rose - rózsa, rózsát
had - kellett, megvolt, rendelkezett
express - kifejezni
gone - elment, ment, menve
protect - megvéd
recording - felvétel, felvétele
sitting - ülni, ülés, ülő
quit - hagy, otthagy
sounds - hangokat, hangzik
start school - kezdted
discover - felfedez, felfedezniük, felfedeztem
run out - elfogyott, kifutnak, kifutott
injured - sebesült
cause - okoz
let go - elengedlek
used - használta, szokva
caught - elkapott, elkapta, elkaptam
tying - kötés
welcome - üdvözöllek
die - meghal
serve - felszolgál
take care - vigyázz magadra
pour - öntenék, öntünk
capture - megörökítik, megörökíteni, megörökítenie
driven - vezetve, vezettünk
feel sick - rosszul érezni magát, rosszul érezni magam
fried - sült
took - kivett, (el)vitt(e), vállalta
reminisce - nosztalgiázom, nosztalgiázni
i know - én ismerek, tudok, tudom
excited - izgatott
shop for - Vásárolni, vásárolnom, vásárolni
hide - bújtak, bújnak, bújik
pumpkin - tök, tökös
freeze - megfagy, fagyni, befagy
sit down - leül
freezing - fagyos
play against - játszik egymás ellen, játszanak egymás ellen, játszani egymás ellen
grow up - felnő
contribute - hozzájárulni
develop - fejlődik, (ki)fejleszt, fejlődni
steal - lop
chose - választanék, választottál, választottak
talk to - beszélnünk, beszélünk, beszélhetünk
think - gondolkozik
slept - aludt, aludtunk
doing - csinálva, csinál, csinálni
excuse - kifogása, mentség
pay - kifizet, kifizetni, fizesd
damaged - megrongálódott, megsérül
talk - beszélned, beszélget, beszél
notes - jegyzeteket, jegyzeteinket, jegyzetek
sent - küldtünk, küldtél, küldte
yum - nyami
bake - süt
happen - történik
slowed - lelassult
cheeseburger - sajtburger
noodle - tészta
install - telepíti
provided - biztosítani, ellátott
begun - kezdődött, elkezdett
check - számla
well-dressed - jól öltözött
do laundry - mos
came - származott, jöttünk, megjött
know how to - tud hogyan kell
goes - megy, elmegy, jár
liking - szereted-e, szereti, Szereti
stood - álltam, állt, álltunk
there was - volt
investigate - vizsgálj, utánajárhatunk
break into - betör
fed - etetésért, etetésből, megetették
dislike - nem szeret, utálod
persuade - meggyőz
writing - írás
visited - meglátogattad, meglátogatták, meglátogatott
turn off - kikapcsol
shorts - rövidnadrág
wondering - tűnődve
discouraged - elcsüggedtem, Elcsüggedtem, elcsüggedni
reapply - újra jelentkezem
support - támogatás
married - házas
cleaning - takarítanak, takarít, tisztítok
stop - leállít, állni, abbahagy
advanced - haladó
shoot - lő
impressed - lenyűgöz, lenyűgözött
need to - szükséges, kell
sleeve - kabátujj, ujj, kabát ujja
inquire - utánajárok, érdeklődhet
podium - emelvény, emelvényre, emelvényt
sit - ül
cooperate - együttműködési, együttműködés
cry - sír
tolerate - tűrd el, tolerál
need - szükség van
favor - szívesség, javára
disappear - eltűnnek, eltűnik
have fun - jól érzi magát
rip - elszakad, elszakít
work - munka
immigrate - bevándorol
swear - esküszöm
expired - lejárt
excuse me - elnézést
burn - megéghet
limit - határ, korlát, határa
didn't - nem, sem
farming - gazdálkodás, mezőgazdaság
i hope not - remélem, hogy nem
receive - kap
work out - Edzeni, edzünk, edzel
come over - átjön
argue - vitatkozik
mow - lenyír, nyír, nyírja
timing - időzítés
as far as i know - tudomásom szerint, amennyire én tudom
defend - megvédeni
put together - összeállít
leaves - (fa)levelek, elindul, elutazik
woke up - felébredt, felébredtek
fill - tölt
forgiven - megbocsátott
take - megy, vinni, vennie
decorate - díszít
donate - adományoz
going to - fog, bemenni
welcoming - vendégszerető
qualify - kvalifikálni, kvalifikáljanak, kvalifikálta-e
dig - ásni
make it - elkészítik, készítesz
pop - pop
prove - bebizonyítani
bother - zavar
criticize - kritizálni
how can i help you - hogyan segíthetek önnek
doubt - kétség, kétely
spoken - beszélt(ek), beszéltek
wrote - írt, írtam, írtak
listen to - (meg)hallgat (vkit/vmit), (oda)figyel (vkire), hallgatod
attach - csatolni, fűzz
achieve - elér (célt), érni
challenging - kihívást jelentő
look at - ránéz (valakire)
agree with - érteniük, értek egyet, egyetértek
take a bath - fürdik
advise - tanácsolja, tanácsol
building - épület
bite - harap
mop - felmos, felmossuk, felmosom
lose - veszít
ignore - figyelmen kívül hagyhat, figyelmen kívül hagyni
unmute - bekapcsolja a mikrofont
pierced - átszúrt
speak to - beszél vkivel
seating - ülésrend, ülőhely, helyfoglalás
karate - karate
start work - kezdeni, elkezdem
considering - figyelembe, fontolgatjuk
let's do it - csináljuk
set up - szervez
review - átnéz
painting - festmény
celebrate - ünnepel
dressing - öntet
send - küld
fall off - leesik vmiről, leesnek
ask - kérdez
good to see you - jó látni téged
deliver - (ki)szállít, házhoz visz, kézbesít
run to - odafutnak
smile - mosolyog
breathe - lélegzik
gave - adott, adtak, adta
sunscreen - naptej
get on - felszállnak, felszállni, felszállsz
mind - felfogás, bánnád, tudat
manage - főnök
play cards - kártyázik
confusing - zavaró, zavaróak, összezavaró
chosen - választott(a), választottunk
write down - leír
translate - lefordítja
would you like - kér, kéri, szeretnél
hit - üt
admit - bevallom, beismerni
look - nézd
shut - becsuk
hear - hall
drive - vezet
become - válik
walk - sétál
spell - betűz
talk about - beszélni
enter - bemegy
turn on - bekapcsol
gain - nyertél, nyereség
thrown - dobott
account - számla
pancake - palacsinta
hasn't - nincs
give back - visszaad
paid - fizetted, fizette, fizetett
go to the bathroom - menned, mennie, menjünk
go away - elmenni
retire - nyugdíjba megy
disappointed - csalódott
join - csatlakozz, csatlakozom, csatlakozunk
sold - eladták, eladott, eladtad
sing - énekel
refuse - visszautasítom, megtagadni
suffer - szenved
commit - elkövetni, elkövet, elkövettél
get along - jól kijön
satisfied - elégedett
come here - gyere ide
make sense - értelme van
go to - odamennek
suggest - javasol
get home - hazaér
sign up - jelentkezik
will have - addigra már (csinál majd vki vmit), lesz
drawing - rajz
drove - vezettünk, vezettem, autóztam
pay back - visszafizet
display - bemutatják
collect - gyűjt
pretend - teszel, tenni
affect - (ki)hat vkire/vmire, hatással van, befolyásol
i have - iszom, van, megvan
inform - tájékoztatom, értesítse
deserve - érdemel
ruins - romokban, romjai, romot
come back - visszajön
do you have - nálatok van, nálad van
crosswalk - gyalogátkelő
guide - idegenvezető
insist - ragaszkodott
drawn - rajzolt, rajzolva
designed - tervezték, tervezve, tervezte
imagine - elképzelni
collapse - omlani, összeomlik
ate - evett, ettél, ette
spend - költ
smartphone - okostelefon
misunderstanding - félreértés
marshmallow - pillecukrot
there is - van
prepare - készül
unpack - kicsomagol
reflect - elgondolkodni
forgive - megbocsát
face - arc
ending - befejezés
organized - szervezett
there's - van, ott van
perform - fellép, előadni, lépnek fel
stay home - otthon marad
i'd like - szeretnék
follow up - utánajár
check in - bejelentkezik
include - beleszámít
forgave - megbocsátott
run into - befutni, (ők) befutnak, befut(nak)
limo - limuzin
settle - rendezzük
stamp - bélyeg
rewrite - átírnod
hardworking - szorgalmas
went - ment, jártam, hazamentél
anticipated - várják
would have had - (nekem/neki/…) lett volna
call - hív
sweep - söpör
play - focizunk, játszanak, rögbizem
do you mind if - nem bánja, ha
stolen - elloptak, ellopják, lopott
bought - vettem, vásároltak, vásároltál
pirate - kalóz
had better - jobban teszi
interact - interaktálni
explode - felrobban
swept - felsöpörte
eaten - (meg)ette
escape - szökés
beaten - legyőzött
apply - jelentkezik
come in - bejönnek
draw - rajzol
go to bed - aludni megy
lay - fekszik
had better not - jobban teszi ha nem
wants to - szeretne
hand out - kioszt
animated - animált, animációs
eat breakfast - megreggeliznek
relaxed - nyugodt, kipihent, laza
drink - ital
bring - hoz
take a nap - szundít
get well soon - jobbulást
lying down - feküdtem
accomplish - sikerült elérned, elérjük, érsz el
lie - fekszek, fekszenek, lefekszünk
note - jegyzet
help - segítség, segíteni, segítsenek
shout - kiabál
ride - játék
sunshine - napsütés
pass - átmegy
watch out for - figyelj
tore - kiszakadt
look into - benéznek
upset - feldúlt
overwhelmed - túlterhelt
beat - legyőz(ött), megdönt(ött) pl. rekordot, megver(t)
exhausted - kimerült
go on - folytasd
completed - elvégezte, elvégeztem, befejezve
wore - viseltem, hordtam, viseltél
assuming that - feltéve
come out - kijönni, kijön, kijönnek
kitten - cica, cicát
scream - sikolt, sikoly
choose - választ
know - tudjátok, tud, tudnia
drew - rajzolta, rajzolták
smoke - dohányzik
sledding - szánkózni, szánkózás
girlfriend - barátnő
engaged - eljegyzett
make sure - meggyőződik
whipped cream - tejszínhab
punch - ütéssel
report - jelentés
turn out - kiderül
astonished - elképedt
go swimming - úszni megy
living - élő, lakunk
adopt - örökbe fogadja
connect - csatlakoztat
loving - szeretőd
know how - Tudod
wake up - ébred
hate - utál
marry - házasodni
want to - akarja, akarod, akarom
understand - ért
never mind - ne törődj vele
expecting - számított
blame - felelősséget, hibáztatás, szemrehányás
break up - szakít
see you soon - viszlát hamarosan
notice - észrevesz
would like - kérem, szeretne
pair - pár
extend - kibővíteni
go over - átnéz
do business - üzletel
say - mond
entertaining - szórakoztató
felt - érzett/éreztek, érezte/-ék magát/magukat
training - edzés, teniszedzés, képzés
sidewalk - járda
asking - megkérdezi, kér, kérdezted
did - vásároltál, viseltél, tett
there are - áll, van, vannak
began - elkezdett, elkezdődött, kezdtem
take notes - jegyzetel
cut - vág
blown - elfújta
result - eredmény, eredményt
what do you think of - mit gondolsz
cookbook - szakácskönyv
go - megy
fear - félelem
sank - elsüllyedt
embarrassing - zavarbaejtő
rafting - vadvízi evezés, eveznénk, eveztem
lettuce - saláta
fault - hiba
wound - seb
exist - létezik
complain - panaszkodik
wear - visel
meaning - jelentés, (elvont dologra) értelem
knit - kötni
would you mind - lenne kedved
treat - jutalmamat, kezelésem, vendégül látsz
locate - keressék, megtalál
confused - összezavarodva
link - link
want - akar
met - találkozott
id - személyi igazolvány
I don't mind - nem bánom
homemade - házi
uninteresting - érdektelen
checking account - folyószámla
take out - elővesz
come - jön
kick - rúg
match - mérkőzés
improve - fejlődik, javít (rajta), javíthatják
get into - beszállni, beülnek, szállnak be
made - tette, loptak, rávett
ew - pfuj
how are you doing - hogy vagy
i don't know - nem ismerem, nem ismerek
look after - gondoskodik vkiről
walk the dog - megsétáltatja a kutyát
plug - dugó, csatlakozó
vote for - szavazol
surrounding - körülvevő, környező
hurry - siet
feel about - érzünk kapcsolatban, érzitek kapcsolatban, érzel kapcsolatban
tell - mondanod, megmondom, elárulod
led - irányít/vezet (múlt idő), vezettem
boring - unalmas
hold on - várj
stole - lopták, loptak, lopta
i think so - azt hiszem
carry-on - kézipoggyász, kézicsomag
fail - megbukik
held - fogott, tartott, tartottak
lock - zár, lakat, bezár
participate - részt vesz
bless you - egészségedre
according to - szerint
résumé - önéletrajz
add - hozzáad
rat - patkány
tiring - fárasztó
catering - catering
shake - rázni
sew - varrni
i'd - ajánlanám
used to - valaha, volt szokásunk, régen
represent - képvisel
get out of - ki, kiszállnak
involve - bevonni
